%%%%%%%%%%%%%%%%%%%%
%o...%........%...o%
%.%%.%.%%..%%.%.%%.%
%...... G  G%......%
%.%.%%.%%%%%%.%%.%.%
%.%....% ooo%.%..%.%
%.%.%%.% %%%%.%.%%.%
%o%......P....%....%
%%%%%%%%%%%%%%%%%%%%
